Length=2
KeyCode=BPMFVDTNLZCSZhChShRhXGKNgHR"JWYAIaEIeAiOIoUIuIbpmfvdtnlzcszhchshrhxgknghr'jwyaiaeieaioiouiui
Prompt=
ConstructPhrase=
[Data]
B	Б
P	П
M	М
F	Ф
V	В
D	Д
T	Т
N	Н
L	Л
Z	З
C	Ц
S	С
Zh	Җ
Ch	Ч
Sh	Ш
Rh	Ж
X	Щ
G	Г
K	К
Ng	Ң
H	Х
R	Р
"	Ы
J	Й
W	Ў
Y	Ү
A	А
Ia	Я
E	Ә
Ie	Е
Ai	Э
O	О
Io	Ё
U	У
Iu	Ю
I	И
b	б
p	п
m	м
f	ф
v	в
d	д
t	т
n	н
l	л
z	з
c	ц
s	с
zh	җ
ch	ч
sh	ш
rh	ж
x	щ
g	г
k	к
ng	ң
h	х
r	р
'	ы
j	й
w	ў
y	ү
a	а
ia	я
e	ә
ie	е
ai	э
o	о
io	ё
u	у
iu	ю
i	и